NO textures/wolfenstein/purple_stone.xpm
SO textures/wolfenstein/purple_stone.xpm
WE textures/wolfenstein/purple_stone.xpm
EA textures/wolfenstein/purple_stone.xpm

F 164,169,20
C 153,204,0

111111111111111111111
101000001000000000001
101010101011111110001
100010100010000010001
111110101111101011101
100000101000101000001
101111101011101111111

101011110000011110101
101010110E01100010101
101110100001001010101
100000101001010001111
111111101011111011101
100000101000100010001
101110101110101110111
101000100000100010101
101011111111111010101
100010000000000010001
101010111011111111101
110000010000000000011
111111111111111111111